EA textures/xpm/ea.xpm


NO textures/xpm/no.xpm
SO textures/xpm/so.xpm

WE   textures/xpm/we.xpm


C 102,255,255

F 102,153,51
 
1111
1101
10W1
1111