EA textures/ea.xpm


NO textures/no.xpm
SO textures/so.xpm

WE   textures/we.xpm


F 102,255,255

C 102,153,51
 
1111
1101
10W1
1111