EA textures/xpm/ea.xpm
NO textures/xpm/no.xpm
SO textures/xpm/so.xpm
WE   textures/xpm/we.xpm
F 102,255,255
C 102,153,51
111111  1111111111111111111111111
100101  10N0000000110000000000001
101001  1011000001110000000000001
110001  1001000000000000000000001
111111  1001000000000000000000001
111111111011000001110000000000001
100000000011000001110111111111111
11110111111111010000000000001
11110111111111010000000000001
11110111111111010000000000001
11110111111111010000000000001
11110111111111010000000000001
11110111111111010000000000001
11110111111111010000000000001
11110111111111010000000000001
11110111111111010000000000001
11110111111111010000000000001
11110111111111010000000000001
11110111111111010000000000001
11110111111111011101010010001
11000000110101011100000010001
10000000000000001100000010001
10000000000000001101010010001
1100000111010101111101111000111
11110111 1110101 101111010001
11111111 1111111 111111111111        

