EA textures/xpm/ea.xpm

SP   textures/xpm/tree_left.xpm
SP   textures/xpm/tree.xpm

NO textures/xpm/no.xpm
SO textures/xpm/so.xpm

WE   textures/xpm/we.xpm

D   textures/xpm/door.xpm

C 102,255,255

F 102,153,51

SP   textures/xpm/tree_right.xpm
SP   textures/xpm/tree.xpm


        1111111111111111111111111
        1A00000000110000000000001
        1011000001110000000000001
        1001000000000000000000001
111111111011000001110000000000001
100000000011000001110111111111111
11110111111111010000000000001
1111011111111101110101001AA01
11000000110101011100000010A01
100000000000000011000000D0001
10000000000000001101010010001
11000001110101011111011110N0111
11110111 1110101 101111010001
11111111 1111111 111111111111
